Confident - уверен
Disagree - не согласен
away - прочь
ice - лёд
order - упорядочить
by - по
Purpose - цель
On a regular basis - на регулярной основе (регулярно)
Bring in - приносить
execute - выполнять
until - до тех пор (пока)
whence - откуда
offset - компенсировать
Blame - провина
Below - ниже (среднего)
everything possible - всё возможное
All the best - всё возможное
Happen to - произошло с
Lengths - продолжительность
Sample - пример
Edition - издание
Approve of - одобрять
Rely on - полагаться на
Get used to - привыкнуть
Get rid of - избавиться от
Succeed in - получилось
capitalized - с большой буквы
Absence - отсутствие, недостаток, неявка
outer - внешний
case - случай
Wonderful - Замечательный, чудесный
Developed - развивать (past)
Siblings - братья и сёстры
Saturday - суббота
Valley - долина
Activity - деятельность
Everywhere - везде
The Costs - издержки, расходы
Appearance - внешность
Piss me off - вывести из себя
Switch on - включить
mail - почта
Revised - повторённый, пересмотренный
ascending - возрастаю
loop - цикл
Don't freak out - не паникуй
high - высокий
Square - площадь
around - вокруг
data structure - структура данных
Tall - высокий
Wash up the dishes - мыть посуду
Majority - большинство
also - также
just - только, просто, только что
boyfriend - парень (её)
Dry - сушить
lion - лев
soon - скоро
puddle - лужа
milk - молоко
lambda - лямбда
like - любить
Decade - 10 летие
Funny - забавно
manner - манера
Turn on - включить
app - приложение
Married - женат
Free - (быть) свободным
Suggested - предлагал (past)
quick - быстрый
Calm - спокойный
rain - дождь
Take part - принимать участие
grass - трава
Polite - вежливый
error - ошибка
Provided - обеспечивали (предоставляли)
Sales - продажи
There - там
shift - сдвиг
mad - безумный
Died - умер (past)
Might - возможно (modal)
tent - палатка
In The end - в конце
Correct - правильный
Certainly - конечно
Bilingual - двуязычный (знает два языка)
Bed Sheet - простынь
I washed my face - я вымыл лицо
Anywhere - где угодно
aggregate - агрегировать
forget - забывать
Powder - порошок
taxi - такси
destructor - деструктор
Greatly - очень сильно
easy - легко, лёгкий, спокойно 
Region - район R
Went to the park on foot - пошли в парк пешком (go)
default - по умолчанию
fourteen - 14
kill - убийство
select - выбирать
branch - ветка
Go out - идти на выход, выходить
today - сегодня
top - верх
Tasty - вкусно
Religious - верующая
Expected - ожидал (past)
A couple of questions - пара вопросов
Anniversary - годовщина
hi - привет
child - ребёнок
Get a job - получить работу
What time - в какое время
Edge of the building - край здания
way - путь
full - полный
white - белый
return - возвращаемое значение
warm - тёплый
multiplication - умножение
Simple - простой
Bus station - автовокзал
Required - требовало (past)
lemon - лимон
keep - держать (хранить)
Topic - тема
Append - добавить, присоединять
meat - мясо
eat - кушать
fly - летать
left - левый
recursion - рекурсия
study - учиться
eleven - 11
Sofa - диван
Assistant - ассистент
create - создавать
Community - общество
enjoy - наслаждаться
Useless - бесполезный
inner - внутренний
The staff - сотрудники
Width - ширина
street - улица
Not necessarily - не обязательно
want - хотеть
train - тренировка
Correctly - правильно
hate - ненавидеть
sky - небо
Beginner - новичок
conditional - условный
Certain - уверен
How many - Сколько (друзей)
Start doing - начать делать
Waste time - тратить время
Bicycle - велосипед
January - январь
true - истинный
One more time - еще раз
usual - обычный
device - прибор
translate - переводить
Happily - счастливо
method - метод
capacity - емкость
Refuse to - отказываться _
Face problem - столкнутся с проблемой
learn - учиться
understand - понимать
Bag - сумка
Route - маршрут
finally - наконец
Frighten - пугает
Option - вариант
it seems to be - это кажется
Suggested going - предлагал пойти (past)
value - значение
Question mark - вопросительный знак
pink - розовый
soul - душа
Considerably - значительно (С)
social - общественный
speak - говорить
Mix up - перемешать
public - публичный
Responsible - ответственный
Pocket - карман
abroad - за границей
Compete - соревноваться
Devote to - уделять (время) для
Except for - кроме __(огурцов)
Check - проверить
Revis - повторить, пересмотреть
fox - лиса
Excellent - отлично E
zero - 0
Bring up - воспитывать
Exercise - заниматься спортом
The same - то же самое (два слова)
Behave - ведёт себя
to - в, к
Lost - потеряла
right - правый
wrong - неправильный
Invent - изобретать
Returned - вернулся (past)
job - работа
pointer - указатель
Prefers - предпочитает
spoon - ложка
response time - время отклика
husband - муж, супруг
name - имя, назвать
art - искусство
stone - камень
variable - переменная
person - человек
reference - ссылка
shit - дерьмо
Cabinet - шкаф
Pass me - передай мне
box - коробка
Do The Shopping - делать покупки
ask - спрашивать
Equal - одинаковые
grey - серый
difficult - трудный
June - июнь
Impossible - невозможно
from - из
Right now - прямо сейчас
Drive - управлять (ехать)
a Bit - немного B
bull - бык
Floor - пол
color - цвет
The couple - эти женатики (пара)
Calculate - рассчитать
Change of clothes - сменная одежда
Feeling - чувство
Worry - беспокоить, волноваться
remove - удалять
Useful - полезный
Trousers - брюки
decrement - уменьшать
Church - церковь
Opposite - противоположные
for - для
Prison - тюрьма
Expression - выражение
Late - опоздавший
sister - сестра
hospital - больница
descending - убывающий
Recent - свежая
Put on - надевать (шапку)
put - класть
Afraid of - испуган от
logical - логические операции
cake - пироженое
Go on - продолжать 2 слова
delete - удалять
luck - удача
Prepare - подготовится
drunk - пьяный
with - с
Wise - мудрый
dead - мёртвый
joke - шутка
filter - фильтровать
begin - начинать
Influence - влиять на
Celebrate - праздновать
The only right - единственно верное
Friendly - дружелюбный
Low blow - удар ниже пояса
at first - сначала
near - около, рядом
Manage - уметь (управлять)
In August - в августе
map - отображать
clock - часы
at the beginning of the year - в начале этого года
Go anywhere you want to - иди куда угодно
everything - всё
Tower - башня
lunch - обед
reverse - обращать
Legal - законный
allocate - выделять память
Pay for - платить за
Pan - сковорода
Worker - рабочий
Get dark - темнеет
group - группировать
do - делать
breakfast - завтрак
Get up - вставать
thirteen - 13
Ineffective - неэффективно
trouble - проблема
Goods - товары
Departure - отъезд
Quite seldom - достаточно редко
go - идти
on - на
few - мало
Charge - заведует (чем то)
Artist - художник
Eyes - глаза
Serious - серьезный
fork - вилка
Point at - указать на
dictionary - словарь
bye - пока
mean - означать, иметь в виду
red - красный
Guild - вина
Won - выиграл
son - сын
Whose - чей, чья
seven - 7
Killed - убили (past)
god - бог
Equipment - оборудование
index - индекс
worse - хуже
Colorful - блестящий
together - вместе
flee - спасаться бегством
Repair - исправить
slow - медленный
modern - современный
False - не правда
more - более
Chair - стул
print - печатать
set - устанавливать
Brilliant - блестящий
stack overflow - переполнение стека
On top - сверху
Health - здоровье
young - молодой
In the beginning - в начале
Condition - условия
Remained - оставался (past)
Yard - улица, двор
Full of - полон чего
Different - другой, разные
Career - карьера
Available - доступен
Motorcycle - мотоцикл
compile - компилировать
West Coast - западный берег
finger - палец
size - размер
engineer - инженер
Uncle - дядя
Rich - богатый
Slowly - медленно S
Learn something new - узнать что
small - маленький
look at - смотреть на
Grown Up - взрослый
sit - сидеть
nasty weather - неприятная погода
woman - женщина
Innocent - невинный
Receive - получать, принимать
cry - плакать
call by reference - вызов по ссылке
least - наименее, как минимум
dog - собака
Youth - молодежь
amount - количество (a)
choose - выбирать
Meaning - значение
Thoroughly - тщательно
As soon as possible - как можно быстрее
bird - птица
Leave - покидать
may - мочь
Try new things - пробовать новые вещи
capital - столица
Hotel - отель
fifteen - 15
Spend on - тратить на
Whole night - всю ночь
toothbrush - зубная щётка
abstract - абстрактный
Disappointed - расстроенный
Bowl - миска
Memory - память
increment - увеличивать
summer - лето
Chain - цепь
Depends on - зависит от
yesterday - вчера
Easily - спокойно
Experience - опыт
swim - плавать
Run away - убегай
Attack - атаковать
Afternoon - днем
Enter - входить, вступать, поступать
Share - разделять
tell - говорить (кому то)
ball - мяч
Will finish doing - закончу делать (Будущее)
bottle - бутылка
deallocate - освобождать память
one - 1
Illness - болезнь (простуда)
Birthday - день рождения
still - всё ещё, ещё, до сих пор
any longer - не дольше
love - любить
animal - животное
anybody - любой, никто, всякий (body)
hundred - 100 (сто)
Lucky - везучий
Dangerous - опасно
In spite of - несмотря на (с предлогом)
Familiar - знакомо
feel - чувствовать
spring - весна
Wait for - ждать _ (кого то)
Fourth - четвёртое
Complain - жалуется
Journey - поездка
Divide it into - делить это на
call by value - вызов по значению
Powerful - мощный
no - нет
castle - замок
textbook - учебник
repeat - повторять
into - в
Satisfied with - удовлетворён с
goodbye - до свидания
fall - падать
throw - выбрасывать исключение
Stayed - оставался (past)
Individual - личность
buy - покупать
mix - смешивать
Marry - жениться на
Pronunciation - произношение
Think it over - обдумать это
Punish - наказывать
Apologize - извиняться
Control - контролирую
Huge - огромный
Bell - звон, колокол
sad - грустный
Cost - стоить (глагол)
be able - смогу (будущее)
but - но
Tired of - устал от
Join - присоединится
bed - кровать
Independent of - независимая от, самостоятельный _
Inform of - информировать о
eighteen - 18
work - работать
hello - привет
Criticize - критиковать
Higher - выше
Adapt to - адаптироваться к
autumn - осень
At once - сразу же (во первых)
Resolve the conflict - решить конфликт
fuck - трахать
house - дом
work properly - работать правильно
Both sides - обе стороны
letter - буква, письмо, символ
The window - окно
Pass by - проходят мимо
Whole - вся (площадь)
weather - погода
let - позволять
replace - заменять
country - страна
Skills - навыки
String - нитка, шнурок
Opportunity - возможность
Partly - частично
Thursday - четверг
Convenient - подходящий
I feel sorry for the boy - мне жаль этого парня
Almost - майже, почти
pay - платить
Bad at - плохо от
Ands - заканчивается
jug - кувшин
need - нуждаться
devil - дьявол
find - находить
between - между
run - бежать
November - ноябрь
Insist on - настаивать на
another - другой (мир)
use - использовать
Subway - метро
sometimes - иногда
book - книга
Go away - уйди
they - они
The day before yesterday - позавчера
fill - наполнять
Will it last for - Сколько это продлится?
baby - крошка
nineteen - 19
winter - зима
More than enough - больше чем достаточно
knife - нож
Brave - смелая
always - всегда
last for about - (это будет) длится около
all - все
function - функция
Airplane - самолет
have - иметь
Perfectly - полностью
Root - корень
light - более лёгкий, свет
Strong - сильный
Any case - любой случай
Novel - роман
wish - желать
The way - путь
Achieve this aim - достигнуть этой цели
Boat - лодка
main - главный
anyone - любой
Victim - жертва
Much more - Гораздо более
tiger - тигр
four - 4
communicate - общаться
Careful - осторожно
For example - например
Degree - научная степень
Will Get tired - скоро устанешь
Monday - понедельник
Will Continue doing - будет продолжать делать
Village - село
morning - утро
The end - конец
Despite - не смотря на (одно слово)
Article - статья
school - школа
fortune - удача, случай
sixteen - 16
arithmetic - арифметические операции
Expectedly - ожидаемо
Flight - полет, рейс
Whenever - когда угодно
To get in touch with - связаться с
class - класс
very - очень
each - каждый
Unknown - неизвестно
twelve - 12
see - видеть
Remain - остатся, продержатся
wolf - волк
The study - исследование, изучение
go to work - идти на работу
excuse - извинять
It's just a mouse - это просто мышь
police - полиция
seventeen - 17
Allow - разрешать (дозволяти)
On a business trip - в командировке
Suggest - предлагать
Property - недвижимость
March - март
Take place - проходит (иметь место)
The day after tomorrow - послезавтра
debug - отлаживать
In a year - (выучить) за год
Criminal - преступник
Sheet - лист, страница
Disappeared - исчезли (past)
Salary - зарплата
Present day - сегодня
Agreement - договоренность
Sponge - губка
you - ты
Comb - гребешок
Suddenly - вдруг, внезапно
Angry - злой
dance - танцевать
move - двигаться
here - здесь
explain - объясни
have a good time - хорошо проводить время
three - 3
Have read - прочитать
Confuse - перепутать
mother - мать
February - февраль
tree - дерево
teacher - учитель
Sunday - воскресенье
It's a matter of time - это дело времени
make - делать (что то новое)
Objective - цель (O)
Invite to - приглашать на
sir - сэр
Defend - защищать
Rest - отдыхать
news - новости
Flat - квартира
sugar - сахар
Explanation - объяснения
song - песня
save - спасать
Surprising - удивительный
Participate - принимать участие
Marriage - свадьба
hear - слышать
thousand - 1000
ridge - хребет
Felt - упал
Walk into - зайти внутрь
moon - луна
without - без
Keen on - увлекатся
repository - репозиторий
initialize - инициализировать
Quickly - быстро Q
Passion - страсть
policeman - полицейский
How much - Сколько (денег)
respect - уважать
money - деньги
cold - холодный
town - город (T)
Edge of - край _
goose - гусь
Guide - гид
Inform - информировать
man - человек, мужик
Zoo - зоопарк
snow - снег
Expensive - дорогой
it - это
Effect - последствия
Possible - возможно
Earlier - ранее
Sooner or later - рано или поздно
West - запад
stack - стек
Carefully - осторожно, внимательно, бережно
ok - окей
behind - за
Intermediate - средний (уровень)
pig - свинья
bloody - кровавый
Financial - финансовый
Loud - громко
None of them - никто из них
Really - Действительно
Frequent - часто происходит
read - читать
much - много
Pool - бассейн
silver - серебро
Somehow - как то
place - место
kind - добрый
Unusual - необычно
sell - продавать
party - вечеринка
i mean - я имею в виду
stand - стоять
Phrase - фраза
soup - суп
Translate from into - переводить с на
Neighborhood - район
new - новый
Lend - давать в долг
soft - мягкий
can - может
Per - за (метр за секунду)
Relationships - отношения (с родителями)
Pure - чистый
remember - помнить
beach - пляж
What kind of - какого рода?
list - список
monkey - обезьяна
web - сеть, паутина
Approximately - приблизительно
drink - пить
Approach - подход
little - маленький
shop - магазин
I'll - болен
cheap - дешёвый
Birth - рождение
Reinvent - переизбирать
become - стать
boy - мальчик
Waiter - официант
Forgive - простить
Fat - толстый
Potential - потенциальный
Mention - упоминать
oneself - себя
Tremendous - огромный, потрясающий
add - добавлять
fresh - свежий
Trust - доверяю
Raise - растить
Stay positive - оставаться позитивным
Prayed - молился
chicken - курица, цыплёнок
duck - утка
daughter - дочь
Border - граница
Introduction - вступление
many - много (идей)
along - вдоль
life - жизнь
under - под
hell - ад
Fond of - обожаю
second - второй
tale - сказка
Currency - валюта
Advertising - реклама
Application - заявка
maybe - может быть
notebook - тетрадь
hold - держать
Borrow - брать в долг
Ask for help - попросить помощи
Basket - корзина
food - еда
number - число
generation - поколение
Listen to - слышать кого
Pretty tired - достаточно уставший
fast - быстрый
Unexpectedly - неожиданно
Skirt - юбка
hard - тяжёлый, жёсткий
Nowadays - настоящее время (одно слово)
On Holiday - На выходных
Soap - мыло
Brown - коричневый
never - никогда
hand - рука
Come back - вернуться (два слова)
Comfortable - удобное
mouse - мышь
Foundation - фундамент
Suitcase - чемодан
Especially - особенно, специально
because - потому что
bitwise - побитовые операции
Pair - пара
Desk - письменный стол
However - Однако
everybody - каждый (человек)
relax - расслабляться
Attractive - привлекательный
Special - особенный
The machine - машина
old - старый
Nowhere - нигде
array - массив
Current - текущий (курс)
Aunt - тетка
Evidence - доказательство
Farm - ферма
which - который
lake - озеро
less - менее, меньше
watch - смотреть (телевизор)
what - что
soldier - солдат
Announce - объявить
holiday - праздничный день
Forgive and forget - прощать и забывать
Foreign - иностранный
enough - достаточно
key - ключ
Mortal - смертельный
Definitely - точно!, Определенно, разумеется!
comparison - операции сравнения
Attitude to - отношение к
The worst - самый худший
virtual - виртуальный
To be - быть
fish - рыба
Any more - некогда больше
Follow - следуй (иди за мной)
every - каждый
world - мир
Division - деление
Disease - болезнь (тяжелая)
big - большой
same - тот же
get - получать
Engine - двигатель
Length - длина
Notice - заметят
Should - следует
wait - ждать
Normal - обычный, нормальный
queen - королева
Not Definitely - не точно
Advanced - продвинутый
week - неделя
Miss - соскучиться (за кем
Stage - стадия
Authorities - власти
Good at - хорошо от
pointer arithmetic - арифметика указателей
now - сейчас
six - 6
Lazy - ленивые
cherry - вишня
travel - путешествовать
other - другие
Spoke - говорил (прошлое)
wall - стена
Everyone - все(he, she)
go home - идти домой
Range - диапазон
please - пожалуйста
Award - награда
Grade - класс
nickname - прозвище
Send - отправить
Lawyer - юрист
Will Start doing - начнёт делать
through - сквозь (через)
Rent - арендовать
call - вызов, призыв, зов
not - не
Waste of time - потеря времени
eight - 8
Necessary - необходимый
dolphin - дельфин
Lady - пані
Library - библиотека
Native speaker - носитель языка
father - отец
Serves - подавать (девушка подаёт воду)
Watch your mouth - следи за словами
Threat - угроза
Completely - полностью (согласен)
Make a plan - составить план
Work hard - усердно работать
He is away - он отсутствует (уехал далеко)
Get started - начинай
Island - остров
start - начинать (S)
day - день
change - изменять
room - комната
request - запрос
Garden - сад
half - половина
nothing - ничто
Trip - поездка
jump - прыгать
focused - сосредоточенный
Take a break - сделать перерыв
Stay focused - оставаться сосредоточенным
random - случайный
fight - драться
then - тогда
Follow your dreams - следовать своим мечтам
wash - мыть
catch up - догонять(два слова)
Inconvenient - неудобно (время)
Hard working - трудолюбивый
August - август
month - месяц
The most interesting - самый интересный
conflict - конфликт
he - он
In general - в основном
explore - исследовать
curious - любопытный
Keep it simple - держать все простым
Get some rest - отдохнуть
Take a chance - рискнуть
take off clothes - снимать одежду
head - голова
cool - классный
could - мог
coin - монета
crazy - безумный
somebody - кто нибудь
dear - дорогой, уважаемый
at - в, на
Celebrate success - праздновать успехи
Accept failure - принимать неудачи
so - так
yes/yeah - да
girlfriend - девушка (его)
dark - тёмный
king - король
egg - яйцо
show - показывать
why - почему
Divorced - разведен
Stupid - глупый S
clean the house - убирать дом
elephant - слон
come - приходить
Advertisement - рекламное объявление
third - третий
tax rate - ставка налога
early binding - Ранняя оценка
average - средний
ground - земля
indentation - отступы
Solution to - решение __
close - близкий, закрыть
authorization - авторизация
read a book - читать книгу
Multiply - умножить
Area - область, район
tea - чай
question - вопрос
rat - крыса
picture - картинка
last - последний
about - о
real - реальный
beer - пиво
For years - годами
dirty - грязный
ring - кольцо
Ask for - просит _
Keep practicing - продолжать тренироваться
Sleep on it - обдумать еще раз
calm down - успокоиться
Git - система контроля версий Git
paradise - рай
own - собственный
five - 5
page - страница
year - год
nobody - никто
price - цена
Threshold - порог
Be patient - быть терпеливым
brush your teeth - чистить зубы
tsunami - цунами
protected - защищенный
at the end of the meeting - в конце встречи
anything - что угодно
dream - мечтать
commit - коммит
think - думать
cup - чашка
Busy - занят
bathroom - ванная
give - давать
Separately - раздельно
heap - куча
cook - готовить
check email - проверять электронную почту
off - из, вне
meet friends - встречаться с друзьями
decryption - расшифровка
such - такой
encryption - шифрование
Just in time - как раз вовремя
than - чем, кроме, как
Interested in - заинтересован в
Be yourself - быть самим собой
get dressed - одеваться
Only once in a year - только раз в год?
forward - вперёд
Stay organized - оставаться организованным
far - далёкий
plate - тарелка
Give it a try - попробовать
September - сентябрь
help - помогать
this - этот
who - кто
language - язык
pasta - макароны
Grateful to for - благодарен __(кому за)
pass - сдать (тест)
camelCase - стиль написания camelCase
die - умирать
Take off - снять (одежду)
Include - включает (еда)
Event - событие
Obviously - очевидно
blue - синий
Zip it - закрой рот
comment - комментарий
Keep going - продолжать двигаться вперед
authentication - аутентификация
yield - возвращать последовательность
pass by reference - передача по ссылке
Front of - перед (чем то)
Practice makes perfect - практика делает совершенным
Keep an open mind - оставаться открытым к новому
regression test - регрессионное тестирование
admit - признавать
Because of - из-за (твоей собаки)
Trust your instincts - доверять своей интуиции
Every human - каждый человек
bug - ошибка
two - 2
parent - родитель
hot - горячий
Be grateful - быть благодарным
bread - хлеб
integration test - интеграционное тестирование
cook dinner - готовить ужин
profiler - профилировщик
Another apple - еще одно яблоко
Set a goal - поставить цель
In front - Спереди
sorry - извини
Delicious - очень вкусно
Go to bed - ложиться спать
gloomy - пасмурный
do the laundry - стирать белье
Stay curious - Оставайтесь любопытными
Take your time - не торопись
Opinion - мнение
itself - само
listen to music - слушать музыку
family - семья
Go Shopping - ходить за покупками
first - первый
of - из
Commercial - коммерческий
among - среди
bus - автобус
even - даже
enemy - враг
algorithm - алгоритм
Rightly - правильно (r)
mom - мама
Hurry up - торопиться
testing - тестирование
Live in the moment - жить в настоящем моменте
table - стол
Smile at - улыбается над
kitchen - кухня
chief - начальник
home - дом
Adult - взрослый
Guess - отгадать
teach - учат, обучать
ticket - билет
lesson - урок
Early - рано
glad - радостный, рад (видеть)
push - толкать
Point of view - точка зрения
cheese - сыр
October - октябрь
Tuesday - вторник
module - модуль
net - сеть
snake_case - стиль написания snake_case
over - над
pass by value - передача по значению
On Tuesday - во вторник
constructor - конструктор
No Biggie - не страшно
Give back - отдавать
version control - система контроля версий
any - любой
cookie - куки
PascalCase - стиль написания PascalCase
ten - 10
Furniture - мебель
Walk by - идти мимо
Local - местный
play - играть
answer - отвечать
market - рынок
time - время
button - кнопка
kiss - целовать
blood - кровь
session - сессия
walk - идти пешком
most - наиболее
these - эти
private - приватный
take a bath - принимать ванну
fruit - фрукт
Depend on - зависит от
patient - терпеливый, пациент
platform - платформа
Admit your mistakes - признавать свои ошибки
wing - крыло
Believe in yourself - верить в себя
Wednesday - среда
death - смерть
Each other - друг друга
lose - проигрывать
next - следующий
black - чёрный
wild - дикий
keep in touch - оставаться на связи
Move on - идти дальше
implementation - реализация
Holy crap - чёрт возьми
beautiful - красивый
interpreter - интерпретатор
always the same - всегда одно и тоже
clean - чистый
Help others - помогать другим
get undressed - раздеваться
garbage collection - сборка мусора
queue - очередь
Explore the world - исследовать мир
air - воздух
Department - отдел
face - лицо
win - побеждать
Behaviour - поведение
mirror - зеркало
in - в
Elder - старше
documentation - документация
and - и
Care - забота
Virus - вирус
Diet - диета
Vision - зрение
Mouth - рот
All ears - Во все уши
First sight - первый взгляд
Teeth - зубы
IDE - интегрированная среда разработки
order food - заказывать еду
parameter - параметр
do the dishes - мыть посуду
Cover - открывать, освещать
Exactly - точно! , конкретнее
Exception - исключение
Expect - ожидать
Fear - страх
forest - лес
Univers - вселенная
set up a company - основать компанию
sit down - присесть
upset - расстроенный (U)
Notification - уведомление
Tear tore torn - рвать
Perform - исполнять (выступать)
know knew known - знать
Following - следующие (ошибки)
Choose chose chosen - выбирать
have had had - иметь
Deliver - доставлять
She washed herself - она покупалась
nine - 9
Issue - проблема
Deserved - заслужила
Crime - преступление
Dig dug dug - рыть
Ride rode ridden - водить, ехать
Withdraw withdrew withdrawn - снять деньги
Take took taken - брать
Come came come - вернуть (irregular verbs)
Make made made - делать
be was were been - быть
To our surprise - к нашему удивлению
cost cost cost - стоить
Overpay overpaid overpaid - переплатить
Send sent sent - отправлять
Overcome overcame overcome - преодолеть
mean meant meant - иметь в виду (означать)
Catch caught caught - ловить
Sound - звучать
Sing sang sung - петь
Become became become - стал
Lie lied lied - Врать (не путать с лежать)
Can could - могу, умею
Forget forgot forgotten - забывать
Park there - парковаться там
Midnight - полночь
Drive drove driven - ехать
bring brought brought - принести
Unique - уникальная
Rise rose risen - вставать, подъем (сонце)
Shoot shot shot - стрелять
Grow grew grown - расти, выращивать
Happened to - произошло с
Overeat overate overeaten - переедать
Continue - продолжать
See saw seen - видеть
He washed himself - он покупался
let let let - позволить
Cross - пересекать (улицу)
Had a rest - отдыхал
Attention - внимание
Throw threw thrown - бросать
Feed fed fed - кормить
Write wrote written - писать
Discover - открыть (Америку)
Saint - святой
Speak spoke spoken - разговаривать (говорить)
I washed myself - я покупался
Accident - происшествие
Confirm - подтвердить
Have a rest - отдыхать
victory - победа
run ran run - бежать
Tell told told - говорить кому то
get got got - получать
Tend - тенденция
Fight fought fought - сражаться
Smell smelt smelt - пахнуть
Do did done - делать
Sink sank sunk - тонуть
Last for - длится _
Forgive forgave forgiven - прощать
Allow allowed allowed - разрешить (A)
Singer - певец
Beauty - красота
if - если
Sell sold sold - продать
Buy bought bought - покупать
Example - пример
Task - задача
Break broke broken - ломать
Catch - поймать
break - ломать, перерыв
Turn - поворачивать
try - пробовать
Hear heard heard - слышать
Redo redid redone - переделать
Burn burnt burnt - гореть
Lie lay lain - лежать
Thief - вор
begin began begun - начинать
Eat ate eaten - есть, кушать
Find found found - найти
Wake woke waken - просыпаться
Foresee foresaw foreseen - предвидеть
Fit fit fit - подходит (идёт)
Hurt hurt hurt - обижать, задеть, слегка повредить
Feel felt felt - чувствовать
Hold held held - держать в руках
Dream dreamt dreamt - мечтать
Understand understood understood - понимать
show showed shown - показывать
Keep kept kept - хранить
Steal stole stolen - украсть
Several - несколько
Oversleep overslept overslept - проспать
Swim swam swum - плавать
Lend lent lent - одолжить (кому то)
Ring rang rung - звонить
Hit hit hit - ударить
Wear wore worn - носить (одежду)
Think thought thought - думать
Say said said - сказал
Draw drew drawn - рисовать
Fly flew flown - летать
constant - постоянный, постоянная величина
else - ещё, иначе, кроме
Behave very badly - вести себя очень плохо
Cousin - двоюродный брат
Cut cut cut - резать
Deal dealt dealt - иметь дело
Underpay underpaid underpaid - недоплачивать
Pack - упаковать
Death died die - умер
Give gave given - дать
Parcel - посылка
Negative - отрицательная
Knock at - стучать в
Teach taught taught - преподавать
Sleep slept slept - спать
Misunderstand misunderstood misunderstood - неправильно понять
Go went gone - идти
Spend spent spent - тратить
Light lit lit - зажечь
put put put - положить
Leave Left Left - оставил, покинул
hair - волосы
foot - нога
Establish - основывать, установить
Fault - вина
Pay paid paid - платить
Win won won - выигрывать
learn learnt learnt - учить (учится)
sit sat sat - сидеть
Lose lost lost - терять
Fall fell fallen - упал
set set set - установить
read read read - читать
stand stood stood - встать (он встал)
meet met met - встречать
Call of - отметить
Climate - климат
Define - определять, давать характеристику
Full of joy - полный радости
Have a good flight - желаю хорошего полёта
Immediately - сразу
In trouble - в беде
Intention - намерение
Load - груз
Most of all - больше всего
Possibility - возможность
Pretty - довольно, красиво
Protection - защита
Recover - восстанавливать
Relations - отношения
Rock - камень
Roof - крыша
Smaller - меньше (размер)
Thin - тонкий (книга)
This is a total failure - это полный провал
Title - название
Track - путь
i heard it in the news - я услышал это в новостях
quietly - тихо
Sell for - продать за
Customer - покупатель
Throw away - выбросить
School uniform - школьная форма
Rose by - выросла на (цена)
Ear - ухо
Drug - лекарства, наркотики
Ambulance - скорая помощь
brain - мозг
take a nap - вздремнуть
Jewelry - украшения
put off - откладывать (на потом)
i mean to do it - я хочу сделать это
differently - по другому (иначе)
Were you in trouble - ты был в беде?
Were they under arrest - они были под арестом?
Wedding - свадьба
Wake - будить, поднимать с кровати
Unlikely - маловероятно
truth - правда
The side of the road - узбіччя дороги
Team - команда
Signature - подпись
Relation - связь, отношения
Predict - предсказывать
Pay attention - обращать внимание
Met - знаком
Living room - прихожая комната
Leaf - лист
Getting old - старение
Flutter - порхать
Feel like - хочу
Content - состав, зміст, наполнение
Channel - канал
Accept - принять
Absolutely - совершенно, Абсолютно
Attempt - спроба, попытка
Audience - Аудитория, публика
Be proud of - гордиться за
Boast - хвастаться
Former - бывший
Interest - процент, интерес
Performance - выступление
Permission - разрешение
Plant - растение
Suffer - страдать
Transform - превратиться, трансформировать
Discount - скидка
Fashionable - модный
Break down - сломаться
Unpredictable - непредсказуемый
There was no damage - не было повреждения
The amount - количество
Previously - ранее, предварительно
Intend - намереваться
Instead of - вместо (него)
Give up - бросать (курить)
Fell off into - упал с , на
Efficient - эффективный
Doubt - сомнение
Desire - желание
Currently - В настоящее время, теперь
Able - способный, умеющий
Accustomed - Привыкший
It stopped working properly - Оно перестало работать должным образом
I like better - мне нравится больше
Woke up - проснулся
Existence - существование
Has turned into - превратился в
Likely - Вероятный
Paint - краска
Though - хотя, однако, несмотря на, даже, всё таки
Thrilling - захватывающий
Vacation - отпуск
middleware - промежуточное ПО
Achievement - достижение
Act - поступок
Actress - актриса
Affect - влиять, действовать
Already - уже
Another country - другая страна
Another opportunity - еще одна возможность
Apply - применить, подать заявку, занести
Feet - ноги
Neck - шея
Terrible - ужасный
Establish the order - установить порядок
At last - наконец
Athlete - атлет
Avoid - уникати
Bad - плохой
Band - группа
Beat - бить, победить
Benefit - выгода, польза
Better - лучше
Bigger - больше (размер)
Build - строить
Cancel - отменить
Character - характер
Captain - капитан
Below average - ниже среднего
Injury - сильно задеть, Травма
Acquaintance - Знакомство, знакомый
i leave for - я уезжаю в
Stay true to yourself - оставаться верным себе
Emergency - Чрезвычайная ситуация
Ahead - впереди
Cheaper - дешевле
Classmate - одноклассник
Cleaner - чище (чистота)
Clear - чистый, прозрачный
Cloud - облако
Construction - стройка
Good - хорошо
Good shape - хорошая форма (спорт)
Great - большая (британия), чудова
Goal - цель
Confidence - уверенность
Choice - выбор
Assume - допустил, припустив
After - после
Chest - грудь
whitespace - пробелы
Take responsibility - Возьмите на себя ответственность
Where do we begin - с чего мы начнём
At least - во всяком случае
Half an hour - полчаса
Happy - счастлив
Heat - жара
Honor - честь
Hospitable - гостеприимство
How long time ago was it - как давно это было
Humor - юмор
Impress - впечатлять
In any case I like it here - во всяком случае мне нравится тут
In the fall - осенью
Increase - усилить, увеличить
Inside - внутри
Invite - приглашать
How do they prepare this fish in France - Как готовят эту рыбу во Франции?
He wants to respond to her - он хочет ответить ей
Born - родиться
inheritance - наследование
Lack - нехватка, недостаток
Land - земля, родина, хз
Landscape - ландшафт
Large - большой
Later - позже
Literature - литература
Long - длинный
Loyal - лояльный
More or less - более менее
Mountain - гора
Murder - убийство
Nature - природа
One chapter has turned into a book - один раздел превратился в книгу
On the right way - на правильном пути
Nice - красивый, хороший
Network - сеть
Meet - знакомиться, встречать
Lonely - одинокий
Listen - слушать
Led - управлять
Joy - радость
Circle - круг
Tongue - язык
Before - до, перед
How do i add images to my page - как мне добавить изображения на мою страницу
One point - одно очко
Origin - происхождение
Other countries - другие страны
Other side - другая сторона
Painting - картина
Part - часть
Piece - кусок
Pleasure - удовольствие
Poetry - поэзия
Position - должность
Press - пресса
Postcard - открытка
Permit - разрешение, пропуск
Path - путь
Outside - снаружи
Is there a way to prevent it - Есть ли способ предотвратить это?
Ears - уши, слушать
Composition - сочинение
Older - старше (возраст)
Prevent - запобігти
Production - производство
Proud of - гордится за
Reach - достиг, достигнуть, тянутся
Ready - готов
Reality - реальность
Reduce - уменьшить
Regret - сожалеть
Risky - рискованно
Score - набирать (очки)
Score a goal - забивать гол
Screen - экран
Sensation - сенсация
Shadow - тень
Shape - форма (состояние)
Sharp - острый
Service - услуга
Search - поиск
Produce - производить
Prettier - красивее
Pain - боль
taught me a lesson - преподал мне урок
Previous - предыдущий
Religion - религия
She doesn't affect me - она не влияет на меня
Sand - песок
Sick - больной
Statement - утверждение, Заявление
Instance - случай, пример
I had not assumed anything - Я ничего не предполагал
Sight - зрение, взгляд
Treatment - лечение, уход
It's very kind of you - это очень приятно с твоей стороны
Pregnant - беременна
Short - низкий
Smoke - дым
Soil - земля
Sun - солнце
Suspicious - подозрительно
Surname - фамилия
Strength - сильная сторона, сила
Stamp - марка
Split split split - расставаться
Shy - застенчивый
Over time everything changes - со временем всё меняется
Since - поскольку, с
outstanding - выдающийся
Pie - пирог
Drink drank drunk - пить
River - река
Pond - пруд
Sea - море
Ocean - океан
Hole - яма
With whom - с кем
Employee - сотрудник
For no reason - без причины
Candle - свеча
Tears - слёзы
By heart - наизусть
Response - ответ
She had not earned anything - она ничего не заработала
Sure - уверен
encapsulation - инкапсуляция
Skin - кожа
Cancer - рак
heart - сердце
framework - фреймворк
heavy - тяжёлый
bedroom - спальня
watch TV - смотреть телевизор
waterfall - водопад
or - или
wind - ветер
bear - медведь
must - должен
end - конец, заканчивать
unimportant - не важный
You don't say - не может быть
have fun - веселиться, развлекаться
Simplicity - простота
code review - кодовый обзор, проверка кода
merge - слияние
put on clothes - надевать одежду
Someone had opened the window - Кто то открыл окно
postpone - откладывать (на потом)
fun - веселье
horse - лошадь
again - снова
Perfectly realize - прекрасно осознавать
smile - улыбаться
Is Anybody with you - с тобой кто то есть?
girl - девочка
Judge - судья
city - город
Elementary - элементарный
orange - оранжевый
brother - брат
empty - пустой
guy - парень, чувак
I busy next week - я занят на следующей неделе
well - хорошо
How often - как часто
Speak up - говорить громче
hour - час
upon - на
code style - стиль кода
green - зелёный
apple - яблоко
dinner - ужин
Lead to - приводит к
Only once - только раз
message - сообщение
meditate - медитировать
Clever - умный
tomorrow - завтра
As far as i know - насколько я знаю
surf the internet - серфить в интернете
Consequence - последствие
that - тот
sleep - спать
those - те
evening - вечер
polymorphism - полиморфизм
April - апрель
night - ночь
static - статический
flower - цветок
speech - речь
water - вода
know - знать
Corner - перекресток
kingdom - королевство
compiler - компилятор
Just in case - на всякий случай
Guard - охранник
Work towards your goal - работать на достижение цели
take a shower - принимать душ
road - дорога
someone - кто нибудь
eye - глаз
believe - верить
cat - кошка
twenty - 20
Competition - соревнование
Damage - повреждение
Danger - опасность
Crop - урожай
Friday - пятница
live - жить
present - подарок
some - некоторое количество
Deep - глубоко
Devote - уделять
Direction - инструкция, направление
Dust - пыль
Efforts - усилия
Enthusiasm - энтузиазм
Entrance - вход
Exist - существовать
Effort - усилие
Never lose hope - никогда не терять надежду
send a text message - отправлять текстовое сообщение
pencil - карандаш
bike - мотоцикл
Sentence - речення
go for a walk - идти на прогулку
Fluently - свободно
Field - поле
Finish - закончить
Fire - огонь
Flute - флейта
For instance - например (сыр)
From which direction - с какого направления
Gas - газ
Gasoline - бензин
I'm not in shape - я не в форме
Suit - подходить (по)
Theater - театр
Thick - толстый (книга)
I have nothing to do with this matter - я не имею отношения к этому делу
Force - заставить
pull - тянуть
Learn from your mistakes - учиться на своих ошибках
cache - кэш
hunt - охотиться
Disturb - мешать
Earth - земля
This problem has nothing to do with you - эта проблема не имеет к тебе отношения
Total - полный, суммарный
Trend - тенденция
Twice - дважды
stand up - встать
using - испольЗУЯ
work for - Работать на
Country house - загородный дом
Arm - рука
Courage - отвага
Throw at me - бросил в меня
Stylish - стильная
Subject - предмет
Throw to me - бросил мне
Masterpiece - шедевр
Promise - обещание
mind - разум
Stay humble - оставаться скромным
Face your fears - преодолеть свои страхи
Thought - мысль
I lay down - я лёг
I'm ready for the consequences - Я готов к последствиям
Drown - тонуть (человек)
Age - возраст
quantity - количество
Single - один
Impolite - невежливый
final - последний, решающий
He drowned - он утонул
ship - корабль
Jacket - куртка, пиджак
Hook - крюк
There was a great lack of rice that year - В том году было большое нехватка риса
The teacher had given me the answer - учитель дал мне ответ
Cycling - кататься на велосипеде
Courageously - отважно
unit test - модульное тестирование
Cherish your loved ones - дорожить близкими
assignment - операция присваивания
Embrace change - принимать перемену
Install - установить
download - скачать
unpack - распаковать
Thoughtful - задумчивый
fake - поддельный
On Wednesdays - по средам
memory leak - утечка памяти
Clothes - одежда
cut - резать
Windy - ветреный
Wheel - колесо
iteration - итерация
Write it down - записывать что то
only - только
Shirt - рубашка
Stay - остаться
On time - вовремя
spider - паук
Guest - гость
The following - следующие (вопросы)
write - писать
Sign - подписать
During - на протяжении (моего сна)
window - окно
Earn - заработать
Usually - обычно
object - объект
Cheaply - дешево
Entry - вход
Abilities - способности
Front - перед (домом)
As always - как всегда, як завжди
Continue doing - продолжить делать
Rude - грубый
Introduce - представить
open - открывать
Vehicle - транспорт
hope - надеяться
update - обновлять
I thought you had found the suitcase - Я думал, что вы нашли чемодан
I had not eaten since Tuesday - я не ел со вторника
Leg - нога
Passed - сдал, прошел (past)
Take on - взять на
bruh - братан
switch - переключатель
Report - отчёт
she - она
Improve - улучшить
Slim - стройный
North - север
body - тело
Significantly - значительно (S)
Look it up in a dictionary - найти это в словаре
Wait for him - ждать его
nose - нос
Famous - известный
word - слово
game - игра
Educated - образованный
prepend - добавлять в начало
door - дверь
visa - виза
where - где
star - звезда
Finish it - закончить это
when - когда
wife - жена
stop - останавливать
Description - описание
Decision - решение
interface - интерфейс
Interrupt - перебивать
low - низкий
Amazing - восхитительно
As - в то время когда (я ем _ я гуляю)
foreach - для каждого
Belong to - принадлежать
Avenue - проспект
Alone - (живёт) сама
friend - друг
space - космос, пространство
cow - корова
Absent - отсутствует
apartment - квартира (A)
camel - верблюд
Reached - достиг
Data - данные
Living - живой
eagle - орёл
down - вниз
See you tomorrow - увидимся завтра
By profession - по профессии
I started to cover this subject - я начал освещать эту тему
Armchair - кресло
Vegetables - овощи
Razor - бритва
sing - петь
Double - удвоить
Important - важный
strange - странный
pen - ручка
yellow - жёлтый
Moved - переехал (past)
Poor - бедный
car - автомобиль
Success - успех
A lot - много
December - декабрь
sort - сортировать
toilet - туалет
people - люди
He is out - его нет дома (но он рядом)
So what - ну и что?
juice - сок
tonight - сегодня вечером
Regular verbs - Обычные глаголы
Irregular verbs - Неправильные глаголы
Generous - щедрый
Safe - безопасно
Complaint - жалоба
Belt - ремень
Pit - яма
Adjective - прилагательное
Fall in love - влюбляться
Few friends - мало друзей
Little time - мало времени
Others - другие (без существительного)
Scientific research - научное исследование
Law - закон
Towards - в направлении
Economical - экономный
Economy - экономика
Economic - экономический
Society - общество
Elections - выборы
Hero - герой
Pet - питомец
Hang hung hung - вешать
Require - требовать
Spoil spoilt spoilt - портить
Lay laid laid - класть
Deny - отрицать
Express - выражать
Admire - восхищаться
Bite bit bitten - кусать
Tips and tricks - уловки и трюки
Consider - учитывать
Compare - сравнивать
See the difference - увидеть разницу
Illegal - незаконно
Against the law - противозаконно
Get well soon - Поправляйся
Measure - измерение
Develop - развивать
Amazed by - поражён
Prepare for - готовится к
Subscribe to - подписаться на
Complain about - пожаловаться на
Bored with - наскучило
Blow blew blown - дуть
Inspire - вдохновлять
Accuse - обвинять
At this point - в данный момент
Deserve - заслуживать
Cause - причина
Center - центр
Responsibility - ответственность
Scientists - учёный
Hide hid hidden - прятать
Revise - повторить
Demand - спрос, Требовать
I'll do My best - я сделаю всё возможное
Disadvantage - недостаток
Quiet - тихо
Formation - образование, Формирование
Rarely - редко
Seldom - редко
Court - суд
Peace - мир
A change of clothes - сменная одежда
Exit_1 - выход
Failure - провал
Fair - ярмарка, честно, справедливо
Faith - вера
Fashion - мода
Fell - упал
Joi - радость
Sweet - сладкий
Symbol - символ
Universe - вселенная
Used to - привык к
Used - привык
View - вид
Talk - разговаривать
Volcano - вулкан
Violin - скрипка
Woods - лес
Wood - дерево, древесина, лес
What made him change his mind - что заставило его изменить свое мнение
ago - назад (час назад)
bitterly - горько
favor - одолжение
had a good time together - провели хорошо время вместе
i cut myself - я порезался
Take - взять
A well paid job - хорошо оплачиваемая работа
My best - всё возможное
Supper - ужин
Get well - выздороветь
Take into account - взять во внимание
Angry with about - рассержен на
My native city - мой родной город
Sense of humor - чувство юмора
Conclusion - вывод
Century - век
Weak - слабый
he Gets - он получает
Non of us - никто из нас
Serve - подавать
Fits - подходит (одежда)
Imagine - воображать
Spacious - просторная
I hear it for the first time - я слышу это первый раз
give up smoking - бросить курить
Unlike - маловероятно
Younger - младше (возраст)
Vote - голос
While - в то время
Directly - Напрямую (сказать)
Government - правительство
Spelling - правописание
Close to his heart - близко к его сердцу
Decrease - уменьшать
Went on - продолжил
i heard it on tv - я услышал это по телевизору
Count on - рассчитывать на
Find out - Выяснить
Surprised by - удивлён от
Take into consideration - взять во внимание
To what degree - в какой степени
Reliable - надежный
Notify - уведомить
Middle - середина
Impress by - впечатлен от
Give a speech - выступить с промова
Go hand in hand - идти плечо к плечу
Unit - единица измерения, подразделение
Science - наука
Computer science - информатика
Speed - скорость
Distance - расстояние
Volume - объём
Members - участники
Take care - заботится
Mass - масса
Scale - шкала
Surface - поверхность
Technique - техника
Temperature - температура
Definition - определение
Quality - качество
Fully - полностью
Reply - ответ (реплика)
Limit - граница
Formula - формула
Would - как бы
Refusal - отказ
Robbery - ограбление
Ghost - привидение
React to - реагировать на
Count on - рассчитывать на
Reason for - причина __
At the moment - в данный момент
Timetable - расписание
Schedule - график
Invitation - приглашение
Spelling mistake - грамматическая ошибка
Taxes - налоги
War - война
Strategy - стратегия
Army - армия
Debts - долги
Argument - спор
Navy - флот
Violence - насилие
Wealth - богатство
Weapon - оружие
header - заголовок
Parliament - парламент
Governor - губернатор
Campaign - компания
Laws - законы
On my own - самостоятельно
Above - выше (среднего)
Accustomed to - привык к
Disapprove - не одобрять
Concept - понятие
Chemistry - химия
Publication - издание
Accuse of - обвинять в
Ready for - готов к
Consist of - состоять из
Advantage - преимущество
Arrive in at - прибывать
he Teach me a lesson - он преподал мне урок
What he had written was true - что он написал было правдой
I am going to ask them - я позже спрошу их
Power - власть
Conversation - разговор
All my best - всё возможное
Income - доход
Writing - письмо
To what extent - в какой степени
Depth - глубина
Dot - точка
Investigation - исследование
Insurance - страховка
Safety - безопасность
Investment - инвестиция
Freedom - свобода
Leader - лидер
Mayor - мэр
Scissors - ножницы
he assumes - он предпологает
Describe - описывать
toy - игрушка
thing - вещь
owe them - Должен им
In total - всего (нас всего)
how - как
too - слишком
often - часто
Laugh at - смеяться над
